{
	"grid": [
		"100000000000000001",
		"000000000000000000",
		"000000000000001000",
		"000000000000000000",
		"000000000000000000",
		"001000000000000000",
		"000001000000000000",
		"000000000000000000",
		"000000000000000000",
		"000000000000000000",
		"000000000000000000",
		"000000000000000000",
		"000000100000000000",
		"000000000000000000",
		"000000000000000000",
		"000000000000000000",
		"000000000010000000",
		"000000000000000000",
		"000000000000000000",
		"000000000000000000",
		"000000000000000000",
		"000000000000000000",
		"000000000000000000",
		"000000000000000000",
		"000000000000000000",
		"000000000000000000",
		"000000000000000000",
		"000000000000000000",
		"000000000000000000",
		"000000000000000000"
	]
}